WE textures/aaaaaaaaaaaaaaaaaaaaaaaaa.xpm
SO textures/bassemallerftg.xpm
NO textures/bassem1.xpm
EA textures/bassemelephant.xpm

F 234,231,52
C 32,64,255

111111111111111
110100000001001
110100111N10001
110000010000001
100000000000001
100000000000001
111111111111111
111111111111111
111111111111111
111111111111111
111111111111111
