NO textures/bassem1.xpm
SO textures/bassemallerftg.xpm
WE textures/bassemdemon.xpm
EA textures/bassemelephant.xpm

F 234,231,52
C 32,64,0

111111111111111
11010000000F001
11S100111D10001
1100000F0000001
100000000000001
100M00000000001
111111111111111
111111111111111
111110111111111
111111111111111
111111111111111
