NO textures/dog4.xpm
SO textures/dog.xpm
WE textures/dog2.xpm
EA textures/dog5.xpm

F 123,10,1
C 200,201,200

        1111111111111111111111111
        1000000000110000000000001
        1011000001110000000000001
        1001000000000000000000001
111111111011000001110000000000001
100000000011000001110111111111111
11110111111111011100000010001
11110111011111010101010010001
11000011N11101011100000010001
10000000000000001100000010001
10000000000000001101010010001
1100000000010101111101111000111
10000000000001111111111111111
1100000000000001
100000N000000111
1100000000000001
1000000000000111
1100000000000001
1000000000000111
1111111111111111
